#R#####################
#.#.......#.#.........#
#.#.#.###.#.#.#######.#
#...#...#...#.#...#...#
#.#####.#####.#.#.#.###
#.....#.....#C#.#.#.#.#
#.#########.###.#.#.#.#
#.#.....#...#...#...#.#
#.#.###.#.#.#.#######.#
#.#.#.....#.#...#.....#
#.#.###########.###.#.#
#.#.#.........#.....#.#
###.#.#######.#######.#
#...#.#.....#.........#
#.###.#####.###########
#.....................#
#######################